1111111110111
00010000000C0
1000011111001
1P0011E000001
1111111111011
